1 1 1 1 1 1 1 1 1 1 1 1 1 1 1 1 1 1 1 1
1 0 0 0 1 0 0 0 0 0 0 0 0 0 0 0 0 0 1 1
1 0 1 0 1 0 1 1 1 1 1 1 1 1 1 1 1 0 1 1
1 0 1 0 1 0 1 0 0 0 0 0 0 0 0 0 1 0 1 1
1 0 1 0 1 0 1 0 1 1 1 1 1 1 1 0 1 0 1 1
1 0 1 0 1 0 1 0 1 0 0 0 0 0 1 0 1 0 1 1
1 0 1 0 1 0 1 0 1 0 1 1 1 0 1 0 1 0 1 1
1 0 1 0 0 0 1 0 1 0 1 0 0 0 1 0 1 0 1 1
1 0 1 1 1 0 0 0 0 0 1 0 1 1 1 0 0 0 1 1
1 0 0 0 0 0 0 0 0 0 1 0 1 0 0 0 1 1 1 1
1 1 1 1 1 1 1 1 1 0 1 0 1 0 1 0 1 1 1 1
1 1 1 1 1 1 1 1 1 0 1 0 1 0 1 0 0 0 1 1
1 1 1 1 1 1 1 1 1 0 1 0 0 0 1 1 1 0 1 1
1 1 1 1 1 0 0 0 0 0 1 1 1 1 1 1 1 0 1 1
1 1 1 1 1 0 0 0 7 0 0 0 0 0 0 0 0 0 1 1
1 1 1 1 1 0 0 0 0 3 7 5 5 5 5 5 5 5 2 1
1 1 1 1 1 0 0 0 0 0 0 0 0 0 0 0 0 0 1 1
1 1 1 1 1 1 1 1 1 1 1 1 1 1 1 1 1 1 1 1
1 1 1 1 1 1 1 1 1 1 1 1 1 1 1 1 1 1 1 1
1 1 1 1 1 1 1 1 1 1 1 1 1 1 1 1 1 1 1 1