1 1 1 1 1 1 1 1 1 1 1 1 1 1 1 1 1 1 1 1
1 0 0 0 1 0 7 7 7 7 7 7 7 7 7 7 7 0 1 1
1 0 1 0 1 0 1 1 1 1 1 1 1 1 1 1 1 0 1 1
1 0 1 0 1 0 1 0 0 0 0 0 0 0 0 0 1 0 1 1
1 0 1 0 1 0 1 0 1 1 1 1 1 1 1 0 1 0 1 1
1 0 1 0 1 0 1 0 0 5 5 5 5 5 1 0 1 0 1 1
1 0 1 0 1 0 1 0 1 3 1 1 1 0 1 0 1 0 1 1
1 0 1 0 0 0 1 0 1 3 1 0 0 0 1 0 1 0 1 1
1 0 1 1 1 0 0 0 0 3 1 0 1 1 1 0 0 0 1 1
1 0 0 0 1 0 0 0 0 3 1 0 1 0 0 0 1 1 1 1
1 1 1 1 1 1 1 1 1 3 1 0 1 0 1 0 1 1 1 1
1 1 1 1 1 1 1 1 1 3 1 0 1 0 1 0 0 0 1 1
1 1 1 1 1 1 1 1 1 3 0 0 0 0 1 1 1 0 1 1
1 1 1 1 1 0 0 0 0 0 1 0 1 1 1 1 1 0 1 1
1 1 1 1 1 0 0 0 0 0 0 0 0 0 0 0 0 1 1 1
1 1 1 1 1 0 0 0 0 0 0 0 0 0 0 0 0 0 2 1
1 1 1 1 1 0 0 0 0 0 0 0 0 0 0 0 0 0 1 1
1 1 1 1 1 1 1 1 1 1 1 1 1 1 1 1 1 1 1 1
1 1 1 1 1 1 1 1 1 1 1 1 1 1 1 1 1 1 1 1
1 1 1 1 1 1 1 1 1 1 1 1 1 1 1 1 1 1 1 1